{
  "name": "l003",
  "back": "l002",
  "next": "l004",
  "moves": 28,
  "field": [
    "#", "#", "#", "#", "#", "#", "#", "#", "#", "#",
    "#", "+", "+", "+", "6", "+", "+", "+", "+", "#",
    "#", "+", "#", "#", "#", "#", "#", "+", "#", "#",
    "#", "+", "+", "+", "5", "+", "+", "+", "+", "#",
    "#", "+", "#", "#", "#", "#", "#", "+", "#", "#",
    "#", "+", "+", "+", "2", "+", "+", "+", "+", "#",
    "#", "+", "+", "+", "+", "+", "#", "+", "+", "#",
    "#", "#", "#", "#", "#", "#", "#", "#", "#", "#"
  ],
  "solution": [
    {
      "position": 18,
      "marble": 2
    },
    {
      "position": 27,
      "marble": 5
    },
    {
      "position": 36,
      "marble": 6
    }
  ]
}
