{
  "name": "l006",
  "back": "l005",
  "next": "l001",
  "moves": 42,
  "field": [
    "#", "#", "#", "#", "#", "#", "#", "#", "#", "#",
    "#", "4", "+", "+", "+", "#", "+", "+", "6", "#",
    "#", "+", "#", "#", "2", "#", "+", "+", "#", "#",
    "#", "+", "+", "+", "+", "+", "+", "+", "+", "#",
    "#", "+", "#", "+", "+", "#", "+", "+", "#", "#",
    "#", "+", "#", "+", "+", "#", "+", "+", "+", "#",
    "#", "3", "+", "+", "5", "#", "+", "+", "7", "#",
    "#", "#", "#", "#", "#", "#", "#", "#", "#", "#"
  ],
  "solution": [
    {
      "position": 24,
      "marble": 7
    },
    {
      "position": 34,
      "marble": 4
    },
    {
      "position": 35,
      "marble": 6
    },
    {
      "position": 36,
      "marble": 3
    },
    {
      "position": 37,
      "marble": 5
    },
    {
      "position": 46,
      "marble": 2
    }
  ]
}
